NO assets/n1.xpm
SO assets/s1.xpm
WE assets/w1.xpm
EA assets/e1.xpm

F 220,100,0
C 225,30,0

111111111
1000W0001
111111111
