NO assets/n1.xpm
SO assets/s1.xpm
WE assets/w1.xpm
EA assets/e1.xpm

F 220,100,0
C 225,30,0

111111111111111111111111
100000000000000000000001
100000000000000000000001
100000000000000000000001
100000111110000101010001
100000100010000000000001
100000100010000100010001
100000100010000000000001
100000110110000101010001
100000000000000000000001
100000000000000000000001
100000000010000000000001
100000000000000000000001
100000000000000000000001
100000000001000000100001
100000000000001000000001
111111111000000000000001
100100001000W00000000001
110000101000000010000001
110100001000000000000001
110111111000000000000001
110000000000000000000001
111111111000000000000001
111111111111111111111111
